Dd, Dd, Dd, Dd, Dd, Dd, Dd, Dd, Dd, Dd, Dd, Dd, Dd, Dd, Dd, Dd, Dd, Dd, Dd, Dd, Dd, Dd, Dd, Dd, Dd, Dd, Dd, Dd, Dd, Dd, Dd, Dd, Dd, Dd, Dd, Dd, Dd, Dd, Dd, Dd, Dd, Dd, Dd, Dd, Dd, Dd, Dd, Dd
Dd, Dd, Dd, Dd, Dd, Dd, Dd, Dd, Dd, Dd, Dd, Dd, Dd, Dd, Dd, Dd, Dd, Dd, Dd, Dd, Dd, Dd, Dd, Dd, Dd, Dd, Dd, Dd, Dd, Dd, Dd, Dd, Dd, Dd, Dd, Dd, Dd, Dd, Dd, Dd, Dd, Dd, Dd, Dd, Dd, Dd, Dd, Dd
Dd, Dd, Dd, Dd, Dd, Dd, Dd, Dd, Dd, Dd, Dd, Dd, Dd, Dd, Dd, Dd, Dd, Dd, Dd, Dd, Dd, Dd, Dd, Dd, Dd, Dd, Dd, Dd, Dd, Dd, Dd, Dd, Dd, Dd, Dd, Dd, Dd, Dd, Dd, Dd, Dd, Dd, Dd, Dd, Dd, Dd, Dd, Dd
Dd, Dd, Dd, Dd, Dd, Dd, Dd, Dd, Dd, Dd, Dd, Dd, Dd, Dd, Dd, Dd, Dd, Dd, Dd, Dd, Dd, Dd, Dd, Dd, Dd, Dd, Dd, Dd, Dd, Dd, Dd, Dd, Dd, Dd, Dd, Dd, Dd, Dd, Dd, Dd, Dd, Dd, Dd, Dd, Dd, Dd, Dd, Dd
Dd, Dd, Dd, Dd, Dd, Dd, Dd, Dd, Dd, Dd, Dd, Dd, Dd, Dd, Dd, Dd, Dd, Dd, Dd, Dd, Dd, Dd, Dd, Dd, Dd, Dd, Dd, Dd, Dd, Dd, Dd, Dd, Dd, Dd, Dd, Dd, Dd, Dd, Dd, Dd, Dd, Dd, Dd, Dd, Dd, Dd, Dd, Dd
Dd, Dd, Dd, Dd, Dd, Dd, Dd, Dd, Dd, Dd, Dd, Dd, Dd, Dd, Dd, Dd, Dd, Dd, Dd, Dd, Dd, Dd, Xos, Xos, Xos, Dd, Dd, Dd, Dd, Dd, Dd, Dd, Dd, Dd, Dd, Dd, Dd, Dd, Dd, Dd, Dd, Dd, Dd, Dd, Dd, Dd, Dd, Dd
Dd, Dd, Dd, Dd, Dd, Dd, Dd, Dd, Dd, Dd, Dd, Dd, Dd, Dd, Dd, Dd, Dd, Dd, Dd, Dd, Xos, Cud, Rr^Cov, Rr^Cov, Cud, Dd, Dd, Dd, Dd, Dd, Dd, Dd, Dd, Dd, Dd, Dd, Dd, Dd, Dd, Dd, Dd, Dd, Dd, Dd, Dd, Dd, Dd, Dd
Dd, Dd, Dd, Dd, Dd, Dd, Dd, Dd, Dd, Dd, Dd, Dd, Cd, Dd, Dd, Dd, Rd, Dd, Dd, Xos, Xos, Rr^Cov, Rr^Cov, 2 Kud, Cud, Rd, Dd, Dd, Dd^Vda, Dd, Dd, Dd, Dd, Dd, Dd, Dd, Dd, Dd, Dd, Dd, Dd, Dd, Dd, Dd, Dd, Dd, Dd, Dd
Dd, Dd, Dd, Dd, Dd, Dd, Dd, Dd, Dd, Dd, Dd, Cd, 4 Kd, Cd, Dd^Vda, Dd^Vda, Rd, Dd^Vda, Gd^Fts, Dd, Dd^Vda, Cud, Xos, Rr^Cov, Xos, Rd, Rd, Dd, Rd, Dd^Vda, Dd^Vda, Dd, Dd, Dd, Dd, Dd, Dd, Dd, Dd, Dd, Dd, Dd, Dd, Dd, Dd, Dd, Dd, Dd
Dd, Dd, Dd, Dd, Dd, Dd, Dd, Dd, Dd, Dd, Dd, Cd, Cd, Cd, Gd^Fts, Dd^Vda, Rd, Dd^Vda, Rd, Dd^Vda, Rd, Dd^Vda, Rd, Xos, Rd, Rd, Dd^Vda, Rd, Dd^Vda, Rd, Rd, Dd^Vda, Dd^Vda, Dd, Dd, Dd, Dd, Dd, Dd, Dd, Dd, Dd, Dd, Dd, Dd, Dd, Dd, Dd
Dd, Dd, Dd, Dd, Dd, Dd, Dd, Dd, Dd, Dd, Dd, Dd, Dd, Dd^Vda, Dd^Vda, Dd^Vda, Rd, Rd, Dd^Vda, Rd, Dd^Vda, Rd, Dd^Vda, Rd, Dd^Vda, Rd, Dd^Vda, Dd^Vda, Dd^Vda, Dd^Vda, Dd, Rd, Gd^Fts, Dd, Dd, Dd, Dd, Dd, Dd, Dd, Dd, Dd, Dd, Dd, Dd, Dd, Dd, Dd
Dd, Dd, Dd, Dd, Dd, Dd, Dd, Dd, Dd, Dd, Dd, Dd, Dd, Dd^Vda, Dd^Vda, Dd^Vda, Rd, Dd^Vda, Dd^Vda, Dd^Vda, Gd^Fts, Dd^Vda, Dd^Vda, Dd^Vda, Dd^Vda, Rd, Gd^Fts, Dd^Vda, Cd, Cd, Cd, Rd, Rd, Dd^Vda, Dd, Dd, Dd, Dd, Dd, Dd, Dd, Dd, Dd, Dd, Dd, Dd, Dd, Dd
Dd, Dd, Dd, Dd, Dd, Dd, Dd, Dd, Dd, Dd, Dd, Dd, Dd, Dd^Vda, Dd^Vda, Dd^Vda, Rd, Dd^Vda, Gd^Fts, Dd^Vda, Dd^Vda, Dd^Vda, Dd^Vda, Dd^Vda, Dd^Vda, Rd, Dd^Vda, Dd^Vda, Cd, 3 Kd, Cd, Dd^Vda, Rd, Dd^Vda, Dd^Vda, Dd, Dd, Dd, Dd, Dd, Dd, Dd, Dd, Dd, Dd, Dd, Dd, Dd
Rd, Rd, Rd, Rd, Rd, Rd, Rd, Rd, Rd, Rd, Rd, Dd, Rd, Dd, Dd^Vda, Dd^Vda, Rd, Dd^Vda, Dd^Vda, Dd^Vda, Dd^Vda, Dd^Vda, Dd^Vda, Gd^Fts, Dd^Vda, Rd, Dd^Vda, Dd^Vda, Dd^Vda, Cd, Dd^Vda, Dd^Vda, Gd^Fts, Rd, Dd^Vda, Dd, Dd, Dd, Dd, Dd, Dd, Dd, Dd, Dd, Dd, Dd, Dd, Dd
Ds, Dd, Ds, Dd, Ds, Ds, Ds, Ds, Ds, Dd, Ds, Rd, Ds, Rd, Rd, Dd^Vda, Rd, Dd^Vda, Rd, Dd^Vda, Rd, Dd^Vda, Rd, Dd^Vda, Rd, Rd, Dd^Vda, Dd^Vda, Dd^Vda, Dd^Vda, Dd^Vda, Gd^Fts, Dd^Vda, Rd, Dd^Vda, Dd, Dd, Dd, Dd, Dd, Dd, Dd, Dd, Dd, Dd, Dd, Dd, Dd
Wo, Ds, Wo, Ds, Wo, Wo, Wo, Wo, Wo, Ds, Wo, Ds, Wo, Ds, Ds, Rd, Rd, Rd, Dd, Rd, Dd, Rd, Dd, Rd, Rd, Rd, Rd, Rd, Rd, Rd, Rd, Dd^Vda, Rd, Rd, Dd, Dd, Rd, Dd, Rd, Dd, Rd, Dd, Dd, Dd, Dd, Dd, Dd, Dd
Wo, Wo, Wo, Wo^Bw|, Wo, Wo, Wo, Wo, Wo, Wo, Wo, Wo, Wo, Wo, Wo, Ds, Ds^Bsb|, Ds, Ds, Ds, Ds, Ds^Bsb|, Ds, Ds, Ds, Ds^Bsb|, Ds, Dd^Vda, Dd^Vda, Rd, Dd, Rd, Rd, Dd, Rd, Rd, Dd, Rd, Dd, Rd, Dd, Rd, Rd, Rd, Rd, Dd, Rd, Dd
Wo, Wo, Wo, Wo^Bw|, Wo, Wo, Wo, Wo, Wo, Wo, Wo, Wo, Wo, Wo, Wo, Wo, Wo^Bsb|, Wo, Wo, Wo, Wo, Wo^Bsb|, Wo, Wo, Wo, Wo^Bsb|, Wo, Ds, Ds, Ds, Ds, Dd, Ds, Rd, Dd, Dd, Dd, Dd, Ds, Dd, Ds, Dd, Ds, Dd, Dd, Rd, Dd, Dd
Ds, Wo, Ds, Wo^Bw|, Ds, Ds, Ds, Ds, Ds, Wo, Ds, Wo, Wo, Wo, Wo, Wo, Wo^Bsb|, Wo, Wo, Wo, Wo, Wo^Bsb|, Wo, Wo, Wo, Wo^Bsb|, Wo, Wo, Wo, Wo, Wo, Ds, Wo, Rd, Ds, Ds, Ds, Ds, Wo, Ds, Wo, Ds, Wo^Bw|, Ds, Ds, Ds, Ds, Dd
Dd, Ds, Dd, Ds, Dd, Dd, Dd, Dd, Dd, Ds, Dd, Ds, Ds, Ds, Ds, Wo, Wo^Bsb|, Wo, Wo, Wo, Wo, Wo^Bsb|, Wo, Wo, Wo, Wo^Bsb|, Wo, Wo, Wo, Wo, Wo, Wo, Wo, Wo^Bsb|, Wo, Wo, Wo, Wo, Wo, Wo, Wo, Wo, Wo^Bw|, Wo, Wo, Wo, Wo, Ds
Rd, Dd, Rd, Dd, Dd, Dd, Dd, Dd, Rd, Dd, Rd, Dd, Rd, Dd, Dd, Ds, Ds, Ds, Ds, Ds, Ds, Ds^Bsb|, Ds, Ds, Ds, Ds^Bsb|, Ds, Wo, Wo, Wo, Wo, Wo, Wo, Wo^Bsb|, Wo, Wo, Wo, Wo, Wo, Wo, Wo, Wo, Wo^Bw|, Wo, Wo, Wo, Wo, Wo
Dd, Rd, Dd, Rd, Rd, Rd, Rd, Rd, Rd, Rd, Dd, Rd, Dd^Vda, Rd, Rd, Rd, Rd, Rd, Rd, Dd, Rd, Dd, Rd, Dd, Dd^Vda, Rd, Dd, Ds, Ds, Wo, Ds, Wo, Ds, Wo^Bsb|, Wo, Wo, Wo, Wo, Wo, Wo, Ds, Wo, Ds, Wo, Wo, Wo, Wo, Wo
Dd, Dd, Dd, Dd, Dd, Dd, Dd, Dd, Dd, Dd, Dd^Vda, Dd^Vda, Dd^Vda, Dd^Vda, Dd^Vda, Rd, Dd^Vdr, Dd^Vda, Dd^Vda, Rd, Xos, Rd, Rd, Rd, Rd, Rd, Rd, Dd, Rd, Ds, Dd, Ds, Rd, Ds, Ds, Ds, Ds, Ds, Ds, Ds, Dd, Ds, Dd, Ds, Ds, Ds, Ds, Ds
Dd, Dd, Dd, Dd, Dd, Dd, Dd, Dd, Dd, Dd^Vda, Dd^Vda, Dd^Vda, Dd^Vda, Dd^Vda, Dd^Vda, Rd, Dd^Vdr, Dd^Vda, Cud, Xos, Rr^Cov, Xos, Cud, Rd, Rd, Rd, Dd^Vda, Rd, Rd, Rd, Rd, Rd, Rd, Rd, Rd, Rd, Rd, Rd, Rd, Rd, Rd, Rd, Rd, Dd, Rd, Dd, Rd, Dd
Dd, Dd, Dd, Dd, Dd, Dd, Dd, Dd, Dd, Dd^Vda, Dd, Dd^Vda, Gd^Fts, Dd^Vda, Dd^Vda, Rd, Xos, Xos, Rr^Cov, Rr^Cov, Rr^Kov, Rr^Cov, Rr^Cov, Xos, Xos, Rd, Xos, Xos, Rr, Xos, Xos, Dd^Vda, Dd^Vda, Dd^Vda, Gd^Fts, Dd^Vda, Dd^Vda, Rd, Dd, Dd, Dd, Dd, Dd, Rd, Dd, Rd, Dd, Dd
Dd, Dd, Dd, Dd, Dd, Dd, Dd, Dd, Dd, Dd, Dd, Dd^Vda, Dd^Vda, Dd^Vda, Dd^Vda, Rd, Dd^Vda, Xos, Cud, Rr^Cov, Rr^Cov, Rr^Cov, Cud, Xos, Rd, Rd, Xos, Rr, Rr, Rr, Xos, Dd^Vda, Dd^Vda, Dd^Vda, Dd^Vda, Dd^Vda, Dd^Vda, Rd, Dd, Dd, Dd, Dd, Dd, Dd, Dd, Dd, Dd, Dd
Dd, Dd, Dd, Dd, Dd, Dd, Dd, Dd, Dd, Dd, Dd, Dd, Dd^Vda, Dd^Vda, Dd^Vda, Rd, Gd^Fts, Dd^Vda, Dd^Vda, Xos, Xos, Xos, Dd^Vda, Dd^Vda, Dd^Vda, Rd, Rr, Rr, Rr, Rr, Rr, Dd^Vda, Dd^Vda, Dd^Vda, Dd^Vda, Dd^Vda, Dd^Vda, Rd, Dd, Dd, Dd, Dd, Dd, Dd, Dd, Dd, Dd, Dd
Dd, Dd, Dd, Dd, Dd, Dd, Dd, Dd, Dd, Dd, Dd, Dd, Dd, Dd^Vda, Dd^Vda, Rd, Dd^Vda, Dd^Vda, Gd^Fts, Dd^Vda, Dd^Vda, Dd^Vda, Dd^Do, Dd^Vda, Dd^Vda, Rd, Xos, Rr, Rr, Rr, Xos, Dd^Vda, Dd^Vda, Dd^Vda, Dd^Vda, Gd^Fts, Rd, Rd, Dd, Dd, Dd, Dd, Dd, Dd, Dd, Dd, Dd, Dd
Dd, Dd, Dd, Dd, Dd, Dd, Dd, Dd, Dd, Dd, Dd, Dd, Dd, Dd^Vda, Dd^Vda, Rd, Dd^Vda, Dd^Do, Dd^Vda, Dd^Vda, Dd^Vda, Dd^Vda, Dd^Vda, Dd^Vda, Dd^Vda, Rd, Xos, Rr, Rr, Rr, Xos, Dd^Vda, Dd^Vda, Dd^Vda, Rd, Rd, Dd, Dd, Dd, Dd, Dd, Dd, Dd, Dd, Dd, Dd, Dd, Dd
Dd, Dd, Dd, Dd, Dd, Dd, Dd, Dd, Dd, Dd, Dd, Dd, Dd, Dd^Vda, Rd, Rd, Dd^Vda, Dd^Vda, Dd^Vda, Dd^Vda, Rd, Gd^Fts, Rd, Dd^Vda, Dd^Vda, Rd, Dd^Vda, Xos, Rd, Xos, Dd^Vda, Dd^Vda, Dd^Vda, Dd^Vda, Rd, Dd, Dd, Dd, Dd, Dd, Dd, Dd, Dd, Dd, Dd, Dd, Dd, Dd
Dd, Dd, Dd, Dd, Dd, Dd, Dd, Dd, Dd, Dd, Dd, Dd, Dd, Rd, Dd^Vda, Rd, Rd, Rd, Rd, Rd, Dd^Vda, Rd, Dd^Vda, Rd, Rd, Rd, Rd, Rd, Rd, Dd^Vda, Rd, Rd, Rd, Rd, Dd, Dd, Dd, Dd, Dd, Dd, Dd, Dd, Dd, Dd, Dd, Dd, Dd, Dd
Dd, Dd, Dd, Dd, Dd, Dd, Dd, Dd, Dd, Dd, Dd, Dd, Dd, Dd^Vda, Dd, Rd, Dd^Vda, Dd^Vda, Dd^Vda, Dd^Vda, Dd^Vda, Dd^Vda, Dd^Vda, Dd^Vda, Dd^Vda, Rd, Dd^Vda, Dd^Vda, Dd^Vda, Rd, Dd^Vda, Dd^Vda, Dd^Vda, Dd, Dd, Dd, Dd, Dd, Dd, Dd, Dd, Dd, Dd, Dd, Dd, Dd, Dd, Dd
Dd, Dd, Dd, Dd, Dd, Dd, Dd, Dd, Dd, Dd, Dd, Dd, Dd, Dd, Dd, Dd, Dd, Dd, Dd, Dd, Dd, Dd, Ce, Ce, Ce, Rd, Dd, Dd, Dd, Dd^Vda, Dd, Dd, Dd, Dd, Dd, Dd, Dd, Dd, Dd, Dd, Dd, Dd, Dd, Dd, Dd, Dd, Dd, Dd
Dd, Dd, Dd, Dd, Dd, Dd, Dd, Dd, Dd, Dd, Dd, Dd, Dd, Dd, Dd, Dd, Dd, Dd, Dd, Dd, Ce, Ce, Cf, Ce, Ce, Ke, Ce, Dd, Dd, Dd, Dd, Dd, Dd, Dd, Dd, Dd, Dd, Dd, Dd, Dd, Dd, Dd, Dd, Dd, Dd, Dd, Dd, Dd
Dd, Dd, Dd, Dd, Dd, Dd, Dd, Dd, Dd, Dd, Dd, Dd, Dd, Dd, Dd, Dd, Dd, Dd, Dd, Dd, Dd, Ce, Ce, Cf, Cf, Ce, Ce, Ce, Ce, Dd, Dd, Dd, Dd, Dd, Dd, Dd, Dd, Dd, Dd, Dd, Dd, Dd, Dd, Dd, Dd, Dd, Dd, Dd
Dd, Dd, Dd, Dd, Dd, Dd, Dd, Dd, Dd, Dd, Dd, Dd, Dd, Dd, Dd, Dd, Dd, Dd, Dd, Dd, Dd, Dd, Dd, Ce, Ce, Cf, Cf, 1 Ke, Ce, Ce, Dd, Dd, Dd, Dd, Dd, Dd, Dd, Dd, Dd, Dd, Dd, Dd, Dd, Dd, Dd, Dd, Dd, Dd
Dd, Dd, Dd, Dd, Dd, Dd, Dd, Dd, Dd, Dd, Dd, Dd, Dd, Dd, Dd, Dd, Dd, Dd, Dd, Dd, Dd, Dd, Dd, Dd, Dd, Ce, Ce, Ce, Dd, Dd, Dd, Dd, Dd, Dd, Dd, Dd, Dd, Dd, Dd, Dd, Dd, Dd, Dd, Dd, Dd, Dd, Dd, Dd
Dd, Dd, Dd, Dd, Dd, Dd, Dd, Dd, Dd, Dd, Dd, Dd, Dd, Dd, Dd, Dd, Dd, Dd, Dd, Dd, Dd, Dd, Dd, Dd, Dd, Dd, Dd, Dd, Dd, Dd, Dd, Dd, Dd, Dd, Dd, Dd, Dd, Dd, Dd, Dd, Dd, Dd, Dd, Dd, Dd, Dd, Dd, Dd
Dd, Dd, Dd, Dd, Dd, Dd, Dd, Dd, Dd, Dd, Dd, Dd, Dd, Dd, Dd, Dd, Dd, Dd, Dd, Dd, Dd, Dd, Dd, Dd, Dd, Dd, Dd, Dd, Dd, Dd, Dd, Dd, Dd, Dd, Dd, Dd, Dd, Dd, Dd, Dd, Dd, Dd, Dd, Dd, Dd, Dd, Dd, Dd
