Dd, Dd, Dd, Dd, Dd, Dd, Dd, Dd, Dd, Dd, Dd, Dd, Dd, Dd, Dd, Dd, Dd, Dd, Dd, Dd, Dd, Dd, Dd, Dd, Dd, Dd, Dd, Dd, Dd, Dd, Dd, Dd, Dd, Dd, Dd, Dd, Dd, Dd, Dd, Dd, Dd, Dd, Dd, Dd, Dd, Dd, Dd, Dd, Dd, Dd, Dd, Dd, Dd, Dd, Dd, Dd, Dd, Dd, Dd, Dd, Dd, Dd, Dd, Dd, Dd, Dd, Dd, Dd, Dd, Dd, Dd, Dd
Dd, Dd, Dd, Dd, Dd, Dd, Dd, Dd, Dd, Dd, Dd, Dd, Dd, Dd, Dd, Dd, Dd, Dd, Dd, Dd, Dd, Dd, Dd, Dd, Dd, Dd, Dd, Dd, Dd, Dd, Dd, Dd, Dd, Dd, Dd, Dd, Dd, Dd, Dd, Dd, Dd, Dd, Dd, Dd, Dd, Dd, Dd, Dd, Dd, Dd, Dd, Dd, Dd, Dd, Dd, Dd, Dd, Dd, Dd, Dd, Dd, Dd, Dd, Dd, Dd, Dd, Dd, Dd, Dd, Dd, Dd, Dd
Dd, Dd, Dd, Dd, Dd, Dd, Dd, Dd, Dd, Dd, Dd, Dd, Dd, Dd, Dd, Dd, Dd, Dd, Dd, Dd, Dd, Dd, Dd, Dd, Dd, Dd, Dd, Dd, Dd, Dd, Dd, Dd, Dd, Dd, Dd, Dd, Dd, Dd, Dd, Dd, Dd, Dd, Dd^Edp, Dd^Edp, Dd^Edp, Dd^Edp, Dd^Edp, Dd, Dd, Dd, Dd, Dd, Dd, Dd, Dd, Dd, Dd, Dd, Dd, Dd, Dd, Dd, Dd, Dd, Dd, Dd, Dd, Dd, Dd, Dd, Dd, Dd
Dd, Dd, Dd, Dd, Dd, Dd, Dd, Dd, Dd, Dd, Dd, Dd, Dd, Dd, Dd, Dd, Dd, Dd, Dd, Dd, Dd, Dd, Dd, Dd, Dd, Dd, Dd, Dd, Dd, Dd, Dd, Dd, Dd, Dd, Dd, Dd, Dd, Dd, Dd, Dd, Dd, Dd, Dd, Dd, Dd, Dd, Dd, Dd, Dd, Dd, Dd, Dd, Dd, Dd, Dd, Dd, Dd^Edp, Dd, Dd, Dd, Dd, Dd, Dd, Dd, Dd, Dd, Dd, Dd, Dd, Dd, Dd, Dd
Dd, Dd, Dd, Dd, Dd, Dd, Dd, Dd, Dd, Dd, Dd, Dd, Dd, Dd, Dd, Dd^Edp, Dd^Edp, Dd^Edp, Dd, Dd, Dd, Dd, Dd, Dd, Dd, Dd, Dd^Edp, Dd, Dd, Dd, Dd, Dd, Dd, Dd, Dd, Dd, Dd, Dd, Dd, Dd, Dd, Dd, Dd, Dd, Dd, Dd, Dd, Dd, Dd, Dd, Dd, Dd, Dd, Dd, Dd, Dd, Dd, Dd, Dd, Dd, Dd, Dd, Dd, Dd, Dd, Dd^Edp, Dd, Dd, Dd, Dd, Dd, Dd
Dd, Dd, Dd, Dd, Dd, Dd, Dd, Dd, Dd, Dd, Dd, Dd, Dd^Edp, Dd, Dd, Dd, Dd, Dd, Dd, Dd, Dd, Dd, Dd, Dd, Dd, Dd^Edp, Dd, Dd, Dd, Dd, Dd, Dd, Dd, Dd, Dd, Dd, Dd^Dc, Dd^Dc, Dd, Dd, Dd, Dd, Dd, Dd, Dd, Dd, Dd, Dd, Dd, Dd, Dd, Dd, Dd, Dd, Dd, Dd, Dd, Dd, Dd, Dd, Dd, Dd, Dd, Dd, Dd, Dd, Dd, Dd, Dd, Dd, Dd, Dd
Dd, Dd, Dd, Dd, Dd, Dd^Dc, Dd, Dd, Dd, Dd, Dd, Dd, Dd^Edp, Dd, Dd, Dd, Dd, Dd, Dd, Dd, Dd, Dd, Dd, Dd, Dd, Dd, Dd, Dd, Dd, Dd, Dd, Dd, Dd, Dd, Dd, Dd, Dd, Dd, Dd, Dd, Dd, Dd, Dd, Dd, Dd, Dd, Dd, Dd, Dd^Dc, Dd^Dc, Dd, Dd, Dd, Dd, Dd, Dd, Dd, Dd^Edp, Dd, Dd, Dd, Dd, Dd, Dd, Dd, Dd, Dd, Dd, Dd, Dd, Dd, Dd
Dd, Dd, Dd, Dd, Dd, Dd, Dd, Dd, Dd, Dd, Dd, Dd, Dd, Dd, Dd, Dd, Dd, Dd, Dd, Dd, Dd, Dd, Dd, Dd, Dd, Dd, Dd, Dd, Dd, Dd, Dd, Dd, Dd, Dd, Dd, Dd, Dd, Dd, Dd^Edp, Dd, Dd, Dd, Dd^Edp, Dd, Dd, Dd, Dd, Dd, Dd, Dd, Dd, Dd, Dd, Dd, Dd, Dd, Dd, Dd, Dd, Dd, Dd, Dd^Edp, Dd, Dd, Dd, Dd, Dd, Dd, Dd, Dd, Dd, Dd
Dd, Dd, Dd, Dd, Dd, Dd^Edp, Dd, Dd, Dd, Dd, Dd, Dd, Dd, Dd, Dd, Dd, Dd, Dd, Dd, Dd, Dd, Dd, Dd, Dd, Dd, Dd, Dd, Dd, Dd^Dc, Dd^Dc, Dd, Dd, Dd, Dd, Dd, Dd, Dd^Edp, Dd^Edp, Dd, Dd, Dd, Dd^Edp, Dd, Dd^Edp, Dd, Dd, Dd, Dd, Dd, Dd, Dd, Dd, Dd, Dd, Dd, Dd, Dd, Dd, Dd, Dd, Dd, Dd, Dd, Dd, Dd^Dc, Dd, Dd, Dd, Dd, Dd, Dd, Dd
Dd, Dd, Dd, Dd, Dd, Dd, Dd, Dd, Dd, Dd, Dd, Dd, Dd, Dd, Dd, Dd, Dd, Dd, Dd, Dd, Dd, Dd, Dd, Dd^Edp, Dd, Dd, Dd, Dd, Dd^Dc, Dd, Dd, Dd, Dd, Dd, Dd^Edp, Dd^Edp, Dd, Dd, Dd, Dd, Dd, Dd, Dd, Dd, Dd, Dd, Dd, Dd, Dd, Dd, Dd, Dd, Dd, Dd, Dd, Dd, Dd, Dd, Dd, Dd, Dd, Dd, Dd, Dd, Dd, Dd, Dd, Dd, Dd, Dd, Dd, Dd
Dd, Dd, Dd, Dd, Dd, Dd, Dd, Dd, Dd, Dd, Dd, Dd^Edp, Dd, Dd, Dd, Dd, Dd, Dd, Dd, Dd, Dd, Dd, Dd, Dd, Dd, Dd, Dd, Dd^Dc, Dd, Dd, Dd, Dd, Dd, Dd, Dd, Dd, Dd, Dd, Dd^Edp, Dd, Dd, Dd, Dd, Dd, Dd, Dd, Dd, Dd, Dd, Dd, Dd, Dd, Dd, Dd, Dd, Dd, Dd, Dd, Dd, Dd, Dd, Dd, Dd, Dd, Dd, Dd, Dd, Dd, Dd, Dd, Dd, Dd
Dd, Dd, Dd, Dd, Dd, Dd, Dd, Dd, Dd, Dd, Dd, Dd, Dd, Dd, Dd, Dd, Dd, Dd, Dd, Dd, Dd^Dc, Dd, Dd^Dc, Dd, Dd, Dd, Dd, Dd, Dd, Dd, Dd^Edp, Dd, Dd, Dd, Dd, Dd, Dd, Dd, Dd, Dd, Dd, Dd, Dd, Dd, Dd, Dd, Dd, Dd^Edp, Dd, Dd^Edp, Dd, Dd, Dd, Dd^Edp, Dd, Dd, Dd, Dd, Dd, Dd, Dd, Dd, Dd, Dd, Dd, Dd, Dd, Dd, Dd, Dd, Dd, Dd
Dd, Dd, Dd, Dd, Dd^Edp, Dd, Dd, Dd, Dd, Dd^Edp, Dd, Dd, Dd, Dd, Dd, Dd, Dd, Dd, Dd, Dd, Dd, Dd^Dc, Dd, Dd, Dd, Dd, Dd, Dd, Dd, Dd, Dd, Dd, Dd, Dd, Dd, Dd, Dd, Dd, Dd, Dd, Dd, Dd, Dd, Dd, Dd, Dd, Dd, Dd, Dd, Dd, Dd, Dd, Dd, Dd, Dd, Dd, Dd, Dd, Dd, Dd^Edp, Dd, Dd, Dd, Dd, Dd, Dd, Dd, Dd, Dd, Dd, Dd, Dd
Dd, Dd, Dd, Dd, Dd, Dd, Dd, Dd, Dd, Dd, Dd, Dd, Dd, Dd, Dd, Dd, Dd, Dd, Dd, Dd, Dd, Dd, Dd, Dd, Dd, Dd, Dd, Dd, Dd, Dd, Dd, Dd, Dd, Dd, Dd, Dd, Dd, Dd, Dd, Dd, Dd^Edp, Dd^Edp, Dd, Dd, Dd, Dd, Dd, Dd, Dd, Dd, Dd, Dd, Dd, Dd, Dd, Dd, Dd, Dd, Dd, Dd, Dd, Dd, Dd, Dd, Dd, Dd, Dd, Dd, Dd, Dd, Dd, Dd
Dd, Dd, Dd, Dd, Dd^Edp, Dd, Dd, Dd, Dd^Dc, Dd, Dd, Dd, Dd, Dd, Dd, Dd, Dd, Dd, Dd, Dd, Dd^Edp, Dd, Dd, Dd, Dd, Dd, Dd, Dd, Dd, Dd, Dd, Dd, Dd, Dd^Dc, Dd, Dd, Dd, Dd, Dd, Dd, Dd, Dd, Dd, Dd, Dd, Dd, Dd, Dd, Dd, Dd, Dd, Dd, Dd, Dd, Dd, Dd, Dd, Dd, Dd, Dd, Dd, Dd, Dd, Dd, Dd, Dd, Dd, Dd, Dd, Dd, Dd, Dd
Dd, Dd, Dd, Dd, Dd, Dd, Dd, Dd, Dd, Dd, Dd, Dd, Dd, Dd, Dd^Edp, Dd, Dd, Dd, Dd, Dd, Dd, Dd^Edp, Dd, Dd, Dd, Dd, Dd, Dd, Dd, Dd, Dd, Dd, Dd, Dd, Dd, Dd, Dd, Dd, Dd^Edp, Dd, Dd, Dd, Dd, Dd, Dd, Dd, Dd, Dd, Dd, Dd, Dd, Dd, Dd, Dd^Edp, Dd, Dd, Dd, Dd, Dd, Dd, Cd, Dd, Dd, Dd, Dd, Dd, Dd, Dd, Dd, Dd, Dd, Dd
Dd, Dd, Dd, Dd, Dd, Dd, Dd, Dd, Dd, Dd, Dd, Dd, Dd, Dd, Dd, Dd, Dd, Dd, Dd, Dd, Dd, Dd, Dd, Dd, Dd^Edp, Dd, Dd, Dd, Dd, Dd, Dd, Dd, Dd, Dd, Dd, Dd, Dd, Dd, Dd, Dd, Dd, Dd, Dd, Dd, Dd, Dd, Dd, Dd, Dd, Dd, Dd, Dd, Dd, Dd, Dd, Dd, Dd, Dd, Cd, Cd, Cd, Cd, Cd, Dd, Dd, Dd, Dd, Dd, Dd, Dd, Dd, Dd
Dd, Dd, Dd, Dd, Dd, Dd, Dd, Dd, Dd, Dd, Dd, Dd, Dd, Dd, Dd, Dd, Dd, Dd, Dd^Dc, Dd, Dd, Dd, Dd, Dd, Dd^Edp, Dd, Dd, Dd, Dd, Dd, Dd, Dd, Dd, Dd, Dd^Edp, Dd, Dd, Dd, Dd, Dd, Dd, Dd, Dd, Dd, Dd, Dd, Dd, Dd, Dd, Dd, Dd, Dd, Dd, Dd, Dd, Dd, Dd, Cd, Cd, Ch, Ch, Cd, Cd, Cd, Cd, Dd, Dd, Dd, Dd, Dd, Dd, Dd
Dd, Dd, Dd, Dd, Dd, Dd^Edp, Dd^Edp, Dd, Dd, Dd, Dd^Edp, Dd, Dd, Dd, Dd, Dd, Dd, Dd, Dd, Dd^Dc, Dd, Dd, Dd, Dd, Dd, Dd, Dd, Dd^Edp, Dd^Edp, Dd, Dd, Dd, Dd^Edp, Dd^Edp, Dd, Dd, Dd, Dd, Dd, Dd, Dd, Dd, Dd, Dd, Dd, Dd, Dd, Dd, Dd, Dd, Dd, Dd, Dd, Dd, Dd, Dd, Dd, Dd, Dd, Cd, Cd, Ch, Ch, Cd, 1 Kd, Cd, Cd, Dd, Dd, Dd, Dd, Dd
Dd, Dd, Dd, Dd, Dd, Dd, Dd, Dd, Dd, Dd^Edp, Dd, Dd, Dd, Dd, Dd, Dd, Dd, Dd, Dd, Dd, Dd, Dd, Dd, Dd, Dd, Dd, Dd, Dd, Dd, Dd, Dd, Dd, Dd, Dd, Dd, Dd, Dd, Dd, Dd, Dd, Dd, Dd, Dd, Dd, Dd, Dd, Dd, Dd, Dd, Dd, Dd, Dd, Dd, Dd, Dd, Dd, Dd, Dd, Dd, Dd, Dd, Cd, Cd, Ch, Ch, Cd, Cd, Cd, Dd, Dd, Dd, Dd
Dd, Dd, Dd, Dd, Dd, Dd, Dd, Dd, Dd, Dd, Dd, Dd, Dd, Dd, Dd, Dd, Dd, Dd, Dd, Dd, Dd, Dd, Dd, Dd, Dd, Dd, Dd, Dd, Dd, Dd, Dd, Dd, Dd, Dd, Dd, Dd, Dd, Dd, Dd, Dd, Dd, Dd, Dd, Dd, Dd, Dd, Dd, Dd, Dd, Dd, Dd, Dd, Dd, Dd, Dd, Dd, Dd, Dd, Dd, Dd, Dd, Dd, Dd, Cd, Cd, Cd, Dd, Dd, Dd, Dd, Dd, Dd
Dd, Dd, Dd, Dd, Dd, Dd, Dd, Dd, Dd, Dd, Dd, Dd, Dd, Dd, Dd, Dd, Dd, Dd, Dd, Dd, Dd, Dd, Dd, Dd, Dd, Dd, Dd, Dd, Dd, Dd, Dd, Dd, Dd, Dd, Dd, Dd, Dd, Dd, Dd, Dd, Dd, Dd, Dd, Dd^Edp, Dd, Dd, Dd, Dd, Dd, Dd, Dd, Dd, Dd, Dd, Dd^Edp, Dd^Edp, Dd, Dd, Dd, Dd, Dd, Dd, Dd, Dd, Dd, Dd, Dd, Dd, Dd, Dd, Dd, Dd
Dd, Dd, Dd, Dd, Dd, Dd, Dd, Dd, Dd, Dd, Dd, Dd, Dd, Dd, Dd, Dd, Dd, Dd, Dd, Dd, Dd, Dd, Dd, Dd, Dd, Dd, Dd, Dd, Dd, Dd, Dd, Dd, Dd, Dd, Dd, Dd, Dd, Dd, Dd, Dd, Dd, Dd, Dd, Dd, Dd, Dd, Dd, Dd, Dd, Dd, Dd, Dd, Dd, Dd, Dd, Dd, Dd, Dd, Dd, Dd, Dd, Dd, Dd, Dd, Dd, Dd, Dd, Dd, Dd, Dd, Dd, Dd
Dd, Dd, Dd, Dd, Dd, Dd, Dd, Dd, Dd, Dd, Dd, Dd, Dd, Dd, Dd, Dd, Dd, Dd, Dd^Edp, Dd, Dd, Dd, Dd, Dd, Dd, Dd, Dd, Dd, Dd, Dd^Edp, Dd, Dd, Dd, Dd, Dd, Dd, Dd, Dd^Edp, Dd, Dd, Dd, Dd, Dd, Dd, Dd, Dd, Dd, Dd, Dd, Dd, Dd, Dd, Dd, Dd, Dd, Dd, Dd, Dd, Dd, Dd, Dd, Dd, Dd, Dd, Dd, Dd, Dd, Dd, Dd, Dd, Dd, Dd
Dd, Dd, Dd, Dd, Dd, Dd, Dd, Dd, Dd, Dd, Dd, Dd, Dd^Edp, Dd, Dd, Dd, Dd, Dd, Dd, Dd, Dd, Dd, Dd, Dd, Dd, Dd, Dd, Dd, Dd, Dd, Dd, Dd, Dd, Dd, Dd, Dd, Dd, Dd^Edp, Dd, Dd, Dd, Dd, Dd, Dd, Dd, Dd, Dd, Dd, Dd, Dd, Dd, Dd, Dd, Dd, Dd, Dd, Dd, Dd, Dd, Dd, Dd, Dd, Dd, Dd, Dd, Dd, Dd, Dd, Dd, Dd, Dd, Dd
Dd, Dd, Dd, Dd, Dd, Dd, Dd, Dd, Dd, Dd, Dd, Dd^Edp, Dd, Dd, Dd, Dd, Dd, Dd, Dd, Dd, Dd, Dd, Dd, Dd, Dd, Dd, Dd, Dd, Dd^Edt, Dd, Dd, Dd, Dd, Dd, Dd, Dd, Dd, Dd, Dd, Dd, Dd, Dd, Dd, Dd, Dd, Dd, Dd, Dd, Dd, Dd, Dd, Dd, Dd, Dd, Dd, Dd, Dd, Dd, Dd, Dd, Dd, Dd, Dd, Dd, Dd, Dd, Dd, Dd, Dd, Dd, Dd, Dd
Dd, Dd, Dd, Dd, Dd, Dd, Dd, Dd, Dd, Dd, Dd, Dd, Dd, Dd, Dd, Dd, Dd, Dd, Dd^Edt, Dd, Dd, Dd, Dd, Dd, Rd, Dd, Rd, Dd^Edt, Rd^Edt, Dd^Edt, Rd^Edt, Dd^Edt, Rd^Edt, Dd^Edt, Rd^Dr, Dd, Rd^Edt, Dd, Rd^Edt, Dd, Rd, Dd, Rd, Dd, Rd, Dd, Rd, Dd, Rd, Dd, Rd, Dd, Rd^Edt, Dd^Edt, Dd^Edt, Dd, Dd^Edt, Dd, Dd, Dd, Dd, Dd, Dd, Dd, Dd, Dd, Dd, Dd, Dd, Dd, Dd, Dd
Dd, Dd, Dd, Dd, Dd, Dd, Dd, Dd, Dd, Dd, Dd, Dd, Dd, Dd, Dd, Dd, Dd^Edt, Dd^Edt, Dd^Edt, Dd^Edt, Rd^Edb, Rd^Edb, Rd^Edb, Rd^Dr, Dd^Vda, Rd, Dd, Rd, Xoa, Rd^Edt, Dd, Rd^Edt, Dd^Vda, Rd^Edt, Dd^Edt, Rd^Edt, Rd^Ecf, Rd^Edt, Dd^Vda, Rd, Dd^Vda, Rd, Dd^Vda, Rd, Dd^Vda, Rd, Dd, Rd, Rd, Rd, Dd^Vda, Rd, Rd, Rd, Rd, Dd^Edt, Rd^Edt, Dd^Edt, Dd^Edt, Dd^Edp, Dd, Dd, Dd, Dd, Dd, Dd, Dd, Dd, Dd, Dd, Dd, Dd
Dd, Dd, Dd, Dd, Dd, Dd, Dd, Dd, Dd, Dd, Dd, Dd, Dd, Dd, Dd^Edt, Dd^Edt, Rd, Rd, Rd, Rd^Edb, Dd^Vda, Dd^Vda, Rd^Ecf, Dd^Vda, Dd^Vda, Xoa, Rr, Xoa, Ior, Xoa, Rr, Xoa, Dd^Wm, Dd^Vdr, Dd^Vda, Rd^Dr, Rd^Edt, Dd^Vdr, Dd^Vdr, Dd^Wm, Dd^Vda, Rd^Ecf, Dd^Vda, Dd^Vda, Xoa, Rr, Xoa, Dd, Rd, Dd^Vda, Dd^Vdr, Dd^Vdr, Dd^Vdr, Dd^Vda, Dd^Dr, Rd, Rd, Rd, Dd^Edt, Dd, Dd, Dd, Dd, Dd, Dd, Dd, Dd, Dd, Dd, Dd, Dd, Dd
Dd, Dd, Dd, Dd, Dd^Edp, Dd, Dd, Dd, Dd, Dd, Dd, Dd, Dd, Dd^Edt, Rd^Edb, Rd^Dr, Dd^Vda, Dd^Vda, Dd^Vdr, Dd^Vda, Dd^Vdr, Dd^Vda, Rd, Rd, Dd^Vda, Rr^Dr, Ior, Ior, Iwr^Edb, Ior, Ior, Xoa, Rd, Dd^Vdr, Rd^Edt, Rd^Edt, Rd^Dr, Dd^Vdr, Dd^Wm, Dd^Vdr, Dd^Vda, Rd^Edt, Rd, Xoa, Ior, Ior, Ior, Xoa, Rd, Rd, Rd, Dd^Vdr, Dd^Vdr, Dd^Vdr, Rd^Dr, Rd^Dr, Dd^Vda, Rd, Rd, Dd^Edt, Dd, Dd, Dd, Dd, Dd^Edp, Dd, Dd, Dd, Dd, Dd, Dd, Dd
Dd, Dd, Dd, Dd, Dd, Dd, Dd, Dd, Dd, Dd, Dd, Dd, Rd, Rd^Edb, Dd^Vda, Rd^Edb, Rd^Edb, Dd^Vda, Dd^Vdr, Dd^Ecf, Dd^Wm, Dd^Vda, Dd^Vda, Rd^Dr, Dd^Vda, Xoa, Iwr, Iwr^Edb, Iwr^Edb, Iwr, Ior, Rr^Dr, Rd, Rd, Rd^Edt, Rd^Edt, Rd^Edt, Dd^Vdr, Dd^Edt, Dd^Vdr, Dd^Vda, Rd^Edt, Rd, Rr, Ior, Ior, Ior, Rr, Rd, Dd^Vda, Dd^Vdr, Rd, Rd, Dd^Vda, Rd, Rd, Dd^Vdr, Dd^Vda, Rd, Dd^Edt, Dd, Dd, Dd, Dd, Dd, Dd, Dd, Dd, Dd, Dd, Dd, Dd
Dd, Dd, Dd, Dd, Dd, Dd, Dd, Dd, Dd, Dd, Dd, Rd^Edb, Rd, Dd^Vda, Dd^Wm, Dd^Vda, Dd^Wm, Rd^Edb, Dd^Vda, Dd^Vdr, Dd^Vdr, Dd^Vdr, Dd^Vda, Rd, Rd, Xoa, Ior, Ior, Ior, Ior^Edb, Ior^Edb, Xoa, Dd^Wm, Dd^Vdr, Dd^Vda, Rd^Edt, Rd, Dd^Vda, Dd^Vda, Dd^Edt, Dd^Wm, Rd, Dd^Vda, Xoa, Xoa, Ior, Xoa, Xoa, Rd, Dd^Vdr, Dd^Wm, Dd^Vdr, Dd^Vda, Rd, Rd, Rd, Rd, Dd^Vdr, Rd, Rd, Dd, Dd, Dd, Dd, Dd, Dd, Dd, Dd, Dd, Dd, Dd, Dd
Dd, Dd, Dd, Dd, Dd, Dd, Dd, Dd, Dd, Dd, Rd^Edb, Rd^Edb, Ce, Dd^Vda, Dd^Vdr, Dd^Vda, Dd^Vdr, Rd^Edb, Rd^Edb, Dd^Vda, Dd^Vda, Dd^Vdr, Dd^Vda, Rd, Rd, Xoa, Rr, Xoa, Xos, Xoa, Rr, Xoa, Dd^Vda, Dd^Vdr, Ce, Rd, Rd, Ce, Dd^Vda, Dd^Vda, Dd^Vda, Rd, Dd^Vda, Dd^Vda, Ce, Rr, Rd, Rd, Dd^Vda, Dd^Vdr, Dd^Vdr, Dd^Vdr, Dd^Vda, Rd, Dd^Vda, Dd^Vda, Dd^Vda, Rd^Dr, Dd^Vda, Rd^Dr, Dd, Dd, Dd, Dd, Dd, Dd, Dd, Dd, Dd, Dd, Dd, Dd
Dd, Dd, Dd^Edp, Dd, Dd, Dd, Dd, Dd, Rd, Rd, Rd, Dd^Dr, Dd^Dr, Dd^Wm, Dd^Vdr, Dd^Vdr, Cd, Dd^Vda, Dd^Vda, Rd, Dd^Vda, Ce, Rr^Edb, Rr^Edb, Rr^Edb, Rr, Rr^Dr, Rr, Rr^Edb, Rr^Edb, Rr^Edb, Rr, Rr, Rr, Rr^Ecf, Rr, Rr^Edb, Rr, Rr^Ecf, Rr, Rr^Edb, Rr, Rr^Dr, Rr, Rr, Rr, Rr^Edt, Rr, Rr^Edt, Rr, Rr^Edt, Rr, Rr, Rd, Dd^Vda, Dd^Vda, Dd^Wm, Dd^Vda, Rd, Rd, Dd, Dd, Dd, Dd, Dd, Dd, Dd, Dd, Dd, Dd, Dd, Dd
Dd, Dd, Dd^Edp, Dd, Dd, Dd, Dd, Dd, Rd, Rd^Ecf, Dd^Dr, Rd, Rd, Dd^Vda, Dd^Vda, Cd, 4 Kd, Cd, Dd^Vda, Rd, Rr^Edt, Rr, Rr^Edb, Rr^Ecf, Rr, Rr^Edb, Rr, Rr^Edb, Rr^Dr, Rr^Ecf, Rr, Rr^Dr, Rr, Rr, Rr, Rr^Edb, Rr^Ecf, Rr^Edb, Rr^Edb, Rr^Edb, Rr, Rr^Ecf, Rr, Rr^Edt, Rr, Rr^Edt, Rr, Rr^Edt, Rr, Rr^Edt, Rr^Edt, Rr^Edt, Rr^Edt, Rr^Ecf, Rr, Dd^Vda, Rd, Rd, Dd^Vda, Rd, Rd, Dd, Dd, Dd, Dd, Dd, Dd^Edp, Dd, Dd, Dd, Dd, Dd
Dd, Dd, Dd, Dd, Dd, Dd, Dd, Rd^Edt, Rd^Edt, Dd^Vda, Dd^Vdr, Dd^Vdr, Dd^Vda, Rd, Dd^Vda, Cd, Cd, Cd, Rr^Edt, Rr, Rr^Edt, Rr^Ecf, Rr^Edb, Rr^Dr, Dd^Vdr, Rd, Dd^Wm, Dd^Dr, Rr, Rr^Edb, Rr^Edb, Dd^Vda, Dd^Vdr, Dd^Vdr, Xoa, Rr, Xoa, Xos, Xoa, Rr, Xoa, Dd^Vda, Dd^Vdr, Rd^Edt, Dd^Vdr, Dd^Vdr, Cd, Dd^Vdr, Dd^Wm, Dd^Vda, Dd^Vda, Rr^Dr, Rr, Rr^Edt, Rr^Edt, Rr^Edt, Rr^Dr, Dd^Vda, Dd^Vda, Rd, Rd, Dd, Dd, Dd, Dd, Dd, Dd, Dd, Dd, Dd, Dd, Dd
Dd, Dd, Dd, Dd, Dd, Dd, Dd, Rd^Edt, Dd^Vdr, Dd^Vdr, Dd^Wm, Dd^Wm, Dd^Ecf, Rd^Ecf, Rd, Dd^Vda, Rr^Edt, Rr^Edt, Rr^Ecf, Rr^Edt, Rr^Edb, Rr, Dd^Vda, Dd^Vdr, Dd^Vda, Rd, Dd^Vdr, Dd^Vda, Rr, Rr^Ecf, Rr^Edb, Dd^Edt, Dd^Vdr, Dd^Vdr, Xoa, Iwr, Iwr^Edb, Iwr, Iwr^Edb, Iwr, Xoa, Dd^Vda, Dd^Dr, Rd^Edt, Rd^Dr, Cd, 3 Kd, Cd, Dd^Vdr, Dd^Vdr, Dd^Vdr, Dd^Vdr, Dd^Vda, Rr, Rr^Ecf, Rr^Edb, Rr^Edb, Dd^Vda, Dd^Wm, Dd^Vda, Rd, Dd, Dd, Dd, Dd, Dd, Dd, Dd, Dd, Dd, Dd, Dd
Dd, Dd, Dd^Edp, Dd, Dd, Dd, Rd, Rd, Dd^Vdr, Dd^Vdr, Dd^Wm, Dd^Vdr, Dd^Vda, Dd^Vda, Rr, Rr^Dr, Rr^Edt, Rr^Edt, Rr, Rr^Edb, Dd^Vda, Rd^Edt, Rd^Edt, Rd, Rd, Rd, Rd, Rd, Rr^Dr, Rr^Edb, Rr, Dd^Edt, Dd^Vdr, Dd^Vda, Xoa, Iwr, Iwr^Edb, Iwr^Edb, Iwr^Edb, Iwr, Xoa, Dd^Vdr, Dd^Edb, Rd^Edt, Rd^Edt, Cd, Cd, Cd, Ce, Dd^Wm, Dd^Vdr, Dd^Vdr, Dd^Vdr, Dd^Vda, Rr, Rr^Edb, Rr^Edb, Dd^Vda, Rd, Dd^Vda, Rd, Dd, Dd, Dd, Dd, Dd, Dd, Dd^Edp, Dd, Dd, Dd, Dd
Dd, Dd, Dd, Dd, Dd, Dd, Dd, Rd^Edt, Rd^Edt, Dd^Vdr, Dd^Vda, Dd^Vda, Rr, Rr^Dr, Rr^Edb, Rr^Edb, Rr, Rr, Dd^Vda, Dd^Vdr, Dd^Vdr, Dd^Vdr, Ce, Dd^Vdr, Dd^Vdr, Dd^Vdr, Dd^Vdr, Dd^Vda, Rr, Rr^Edb, Rr, Dd^Vdr, Dd^Vdr, Dd^Vda, Xoa, Iwr, Xoa, Iwr, Xos, Iwr, Xoa, Dd^Vdr, Dd^Vdr, Dd^Vdr, Dd^Vdr, Rd, Rd, Rd^Dr, Rd, Dd^Vda, Dd^Vda, Dd^Vdr, Dd^Vda, Dd^Vda, Rr, Rr^Ecf, Rr^Edb, Rd, Dd^Vda, Rd, Rd, Dd, Dd, Dd, Dd, Dd, Dd, Dd, Dd, Dd, Dd, Dd
Dd, Dd, Dd, Dd, Dd, Dd, Dd, Rd^Edt, Rd^Edt, Rd, Rd, Ce, Ds, Rr^Edb, Rr, Ce, Ds, Ds, Ds, Dd^Vda, Ds, Ds, Ds, Ds, Ds, Ds, Ds, Ce, Rr, Rr, Ce, Dd^Vda, Ds, Dd^Vda, Ds, Rr, Ds^Edt, Xoa, Dd^Edt, Rr, Dd^Vda, Dd^Vda, Ce, Dd^Vdr, Dd^Vdr, Dd^Wm, Dd^Vdr, Rd, Dd^Vda, Rd^Edb, Rd^Edb, Rd^Edb, Rd^Edb, Dd^Vda, Rr, Rr^Dr, Rr^Edb, Dd^Vda, Dd^Vda, Dd^Vda, Rd, Dd, Dd, Dd, Dd, Dd, Dd, Dd, Dd, Dd, Dd, Dd
Dd, Dd, Dd, Dd, Dd, Dd, Ds, Rd, Ds, Ds, Ds, Ds, Ww^Bsb|, Ds, Ww^Bsb|, Ww, Wot, Ww, Wot, Ww, Wwg, Ww, Wwg, Ww, Wot, Ww, Ww, Ww, Ww^Bsb|, Rr, Ww^Bsb|, Ds, Ww, Ds, Ww, Ds^Edt, Ww, Ds^Edt, Ds, Ds, Ds, Ds, Ds, Dd^Vda, Ds, Dd^Vdr, Dd^Vda, Dd^Vdr, Ce, Dd^Vda, Dd^Vda, Dd^Vda, Dd^Vda, Rd^Edb, Rr^Edb, Rr^Edb, Rr^Ecf, Dd^Vda, Dd^Vda, Dd^Vda, Rd, Dd, Dd, Dd, Dd, Dd, Dd, Dd, Dd, Dd, Dd, Dd
Dd, Dd, Ds, Ds, Ds, Ds, Ww, Ds, Ww, Ww, Wot, Ww, Wot^Bsb|, Wot^Bsb|, Wot^Bsb|, Wot, Wot, Wot, Wot, Wot, Wwg, Wwg, Wwg, Wot, Wot, Wot, Wot, Wot, Wwg, Wot^Bsb|, Wot^Bsb|, Ww, Wot, Ww, Wot, Ww, Wot, Ww, Wot, Ww, Ww, Ww, Ww, Ds, Ww, Ds, Ds, Ds, Ds, Ds, Ds, Dd^Vda, Ds, Dd^Vda, Rr^Edb, Rr^Edb, Rr^Edb, Rd, Rd, Dd^Vda, Rd, Rd, Dd, Dd, Dd, Dd, Dd, Dd, Dd, Dd, Dd, Dd
Ds, Ds, Ww, Ds, Ww, Ww, Wot, Ww, Wot, Wot, Wot, Wot, Wot^Bsb|, Wwg, Wwg, Wot, Wot, Wot, Wot, Wot, Wwg, Wwg, Wwg, Wot, Wot, Wot, Wot, Wot, Wot^Bsb|, Wot^Bsb|, Wwg, Wot, Wot, Wot, Wot, Wot, Wot, Wot, Wot, Wot, Wot, Wot, Wot, Wwg, Wwg, Ww, Wot, Ww, Ww, Ds, Ww, Ds, Ww^Bsb/, Ce, Rr^Edb, Rr^Edb, Ce, Rd, Ds, Rd, Ds, Dd, Dd, Dd, Dd, Dd, Dd, Dd, Dd, Dd, Dd, Dd
Ww, Ww, Wot, Wot, Wot, Wot, Wot, Wot, Wot, Wot, Wot, Wot, Wot^Bsb|, Wot^Bsb|, Ww^Bsb|, Wot, Ww, Wot, Ww, Wot, Ww, Wwg, Ww, Wot, Ww, Wot, Ww, Wot, Ww^Bsb|, Wot^Bsb|, Ww^Bsb|, Wot, Ww, Wot, Wot, Wot, Wot, Wot, Wot, Wot, Wot, Wot, Wwg, Wwg, Wwg, Wot, Wot, Wot, Wot, Wot, Wot^Bsb/, Wot^Bsb/, Wot^Bsb/, Ww^Bsb/, Wot^Bsb/, Ww^Bsb/, Ww, Ds, Ww, Ds, Ww, Ds, Ds, Ds, Ds, Dd, Ds, Dd, Dd, Dd, Dd, Dd
Wot, Wot, Wot, Wot, Wot, Wot, Wot, Wot, Ww, Ww, Ds, Ww, Rr, Ww^Bsb|, Rr, Ww, Ds, Ds^Edb, Dd^Edb, Ds, Ce, Ds, Dd^Edb, Ce, Dd^Edb, Ds, Ds^Edb, Ce, Rr^Edb, Ww^Bsb|, Rr^Edb, Ww, Ds, Ww, Ds^Edb, Ww, Ww, Ww, Ww, Ww, Ww, Wwg, Ww, Wwg, Wwg, Wot, Wot, Wot, Wwg, Wot^Bsb/, Wot^Bsb/, Wot^Bsb/, Wwg, Wot^Bsb/, Wot, Wot, Wot, Wot, Wot, Wot, Wot, Ww, Ww, Ds, Ww, Ds, Ww, Ds, Ds, Ds, Ds, Dd
Wot, Wot, Wot, Wot, Ww, Wot, Ww, Ww, Ds, Ds, Dd^Vda, Ce, Rr, Rr, Rr^Dr, Ce, Rd, Rd^Edb, Rd^Dr, Rd^Edb, Rd^Edb, Dd^Edb, Rd^Edb, Rd^Edb, Rd, Rd^Edb, Rd, Ce, Rr, Rr^Edb, Rr^Edt, Ce, Rd^Edt, Ds^Edb, Rd^Edb, Ds, Dd^Vda, Ds, Ds^Edb, Ce, Ds^Edb, Ds^Edb, Ds^Edb, Ww, Ds^Edb, Ww, Ww^Bsb/, Ww^Bsb/, Ww^Bsb/, Wot^Bsb/, Ww^Bsb/, Wwg, Wot, Wot, Wot, Wot, Wot, Wot, Wot, Wot, Wot, Wot, Wot, Ww, Wot, Ww, Ww, Ww, Ww, Ww, Ww, Ds
Ww, Wot, Ww, Ww, Ds, Ds, Ds, Ds, Dd^Edt, Dd^Vdr, Dd^Vdr, Dd^Vda, Rr^Edt, Rr^Edt, Rr^Ecf, Rd, Dd^Vdr, Dd^Edt, Dd^Edt, Dd^Vda, Dd^Vda, Rd, Dd^Vdr, Dd^Vdr, Dd^Vdr, Dd^Vdr, Dd^Vdr, Dd^Vda, Rr^Edt, Rr^Edt, Rr^Ecf, Dd^Edt, Dd^Vdr, Rd^Edt, Dd^Wm, Rd^Edt, Rd^Edt, Dd^Vdr, Dd^Vdr, Dd^Vdr, Dd^Vda, Ds^Edb, Dd^Vda, Ds^Edb, Rr^Edb, Ce, Ce, Ce, Rr, Ww^Bsb/, Ds, Ww, Ww, Ww, Ww, Wot, Ww, Wot, Wot, Wot, Wot, Wot, Wot, Wot, Wot, Wot, Wot, Wot, Wot, Wot, Wot, Ww
Ds, Ww, Ds, Ds, Dd^Wm, Dd^Vda, Dd^Vdr, Dd^Edt, Dd^Vdr, Dd^Vdr, Rd, Rd, Rr, Rr^Dr, Rr^Edb, Rr, Rr^Edt, Dd^Vdr, Rr^Dr, Dd^Vdr, Rr, Rd, Rr, Dd^Vdr, Rr^Dr, Dd^Vda, Rr, Dd^Vda, Rr, Rr^Edt, Rr^Edt, Dd^Vdr, Rr^Edt, Dd^Dr, Rr^Edt, Dd^Vda, Rr^Edt, Rd^Edt, Rr, Dd^Vdr, Rr, Dd^Vda, Rr^Edb, Rr, Rr^Edb, Rr^Edb, Rr^Edb, Ce, Rd, Dd^Vda, Dd^Vda, Ds, Dd, Ds, Dd, Ds, Ds, Ww, Ww, Wot, Ww, Wot, Ww, Wot, Ww, Wot, Wot, Wot, Wot, Wot, Wot, Wot
Dd^Vda, Ds, Dd^Vda, Dd^Vda, Rd, Dd^Vda, Rd, Dd^Vdr, Rd^Ecf, Rd^Dr, Rd, Rd^Ecf, Rr^Edt, Rr^Edb, Rr^Edb, Rr^Edt, Rr^Edb, Rr^Edt, Rr^Ecf, Rr, Rr^Edt, Rr^Edt, Rr^Edt, Rr, Rr, Rr^Ecf, Rr^Edt, Rr, Rr^Cov, Rr^Edt, Rr^Cov, Rr^Edt, Rr^Edt, Rr^Ecf, Rr^Edt, Rr^Edt, Rr^Ecf, Rr^Edt, Rr^Ecf, Rr, Rr^Dr, Rr^Edb, Rr^Ecf, Rr^Edb, Rr^Edb, Rr^Edb, Dd^Vdr, Dd^Vda, Dd^Vdr, Rd, Rd, Dd^Vdr, Dd, Dd, Ce, Dd, Ce, Dd, Dd, Ds, Ds, Ww, Ds, Ww, Ds, Ww, Ww, Ww, Ww, Wot, Ww, Wot
Rd, Dd^Vda, Rd, Rd, Ce, Rd, Rd^Edt, Rd, Rd^Edt, Rd^Edt, Dd^Vda, Dd^Vda, Ce, Rr^Edb, Ce, Rr, Rr^Ecf, Rr^Edt, Rr^Ecf, Rr^Dr, Rr^Edt, Rr^Edt, Dd^Vda, Rr, Dd^Vdr, Rr, Xoa, Rr^Cov, Xoa, Rr^Cov, Xoa, Rr^Cov, Xos, Rr^Edt, Dd^Vdr, Rr^Edt, Dd^Vda, Rr^Edt, Rr, Rr, Rr^Edb, Rr^Edb, Rr, Rr^Edb, Rd^Edb, Dd^Vda, Dd^Vdr, Dd^Vdr, Dd^Vdr, Dd^Vda, Rd, Dd^Vdr, Dd^Wm, Dd, Dd, Ce, Ce, Dd, Dd, Dd, Dd, Ds, Dd, Dd, Dd, Ds, Dd, Ds, Ds, Ww, Ww, Ww
Dd^Vda, Rd, Dd^Vdr, Dd^Vdr, Rd, Rd^Edt, Rd^Edt, Rd^Edt, Dd^Vda, Rd, Dd^Vdr, Dd^Vdr, Rr^Edb, Rr^Edb, Rr, Dd^Vda, Dd^Vdr, Rr^Edt, Rr^Edt, Rr, Rr, Rr^Edt, Rr, Dd^Vdr, Dd^Vdr, Rd, Xoa, Cud, Cud, Xos, Cud, Cud, Xoa, Dd^Vdr, Dd^Vdr, Dd^Vda, Rr, Ce, Rr^Edt, Rr^Edb, Rr^Dr, Rr, Dd^Vda, Rd^Edb, Rd^Edb, Rd, Rd^Dr, Dd^Vda, Dd^Vdr, Dd^Vdr, Ce, Rd, Dd^Vdr, Dd, Dd, Dd, Dd, Dd, Dd, Dd, Dd, Dd, Dd, Dd, Dd, Dd, Dd, Dd, Dd, Dd, Dd, Dd
Dd^Vda, Dd^Edt, Dd^Vdr, Dd^Wm, Rd^Edt, Rd^Ecf, Rd, Dd^Vda, Dd^Edt, Rd, Dd^Edt, Dd^Vdr, Rr^Edb, Rr^Ecf, Rr, Dd^Vdr, Dd^Vdr, Dd^Vda, Rd^Edt, Rr^Edt, Rr, Rr^Dr, Rr^Edt, Rr, Rr^Dr, Rd, Xos, Cud, Cud, 2 Kud, Cud, Cud, Xoa, Dd^Vda, Rr^Edt, Rr, Rr, Rr^Edb, Rr, Ce, Dd^Vda, Dd^Dr, Dd^Wm, Dd^Vdr, Dd^Vdr, Rd, Rd, Rd, Dd^Vda, Dd^Vdr, Dd^Wm, Rd, Rd, Dd^Vdr, Dd, Dd, Dd, Dd, Dd, Dd, Dd, Dd, Dd, Dd, Dd, Dd, Dd, Dd, Dd, Dd, Dd, Dd
Dd^Vda, Dd^Edt, Dd^Vdr, Dd^Vda, Rd^Edt, Rd^Edt, Rd^Ecf, Dd^Edt, Dd^Vdr, Rd^Edt, Dd^Edt, Dd^Wm, Rr^Edt, Rr^Edb, Rr^Dr, Dd^Vdr, Rd^Edt, Rd^Edt, Rd^Edt, Dd^Vdr, Dd^Vdr, Rr^Ecf, Rr, Rr^Edt, Rr^Edt, Rr, Rr, Cud, Xoa, Cud, Xos, Cud, Rr^Ecf, Rr^Edt, Rr^Edt, Rr^Edt, Rr, Rr, Dd^Vda, Rd, Rd, Dd^Edt, Dd^Edt, Dd^Edt, Dd^Vdr, Dd^Vda, Rd, Rd, Dd^Vdr, Dd^Vdr, Dd^Vdr, Rd, Rd, Dd^Vda, Dd, Dd, Dd, Dd, Dd, Dd, Dd, Dd, Dd, Dd, Dd, Dd, Dd, Dd, Dd, Dd, Dd, Dd
Dd^Vda, Dd^Vdr, Dd^Vda, Dd^Vda, Rd, Rd^Edt, Dd^Vda, Dd^Vdr, Dd^Vda, Rd^Edt, Dd^Vda, Dd^Vda, Rr, Rr^Dr, Rr^Edt, Rd, Dd^Vda, Dd^Vda, Dd^Vda, Rd^Edt, Rd, Dd^Vda, Rd, Rr, Rr, Rr^Edt, Rr^Edt, Rr, Rr, Xos, Rr, Rr, Rr, Rr^Edt, Rr^Ecf, Rr, Dd^Vda, Dd^Vdr, Dd^Vdr, Dd^Vda, Dd^Vdr, Rd, Rd, Dd^Vda, Rd, Dd^Vda, Rd, Rd, Dd^Vdr, Dd^Vdr, Dd^Vdr, Rd, Rd, Dd^Vdr, Dd, Dd, Dd, Dd, Dd, Dd, Dd, Dd, Dd, Dd, Dd, Dd, Dd, Dd, Dd, Dd, Dd, Dd
Dd^Vda, Dd^Vda, Dd^Vda, Dd^Vda, Dd^Vda, Rd^Edt, Dd^Vda, Dd^Vda, Dd^Vda, Rd, Dd^Vda, Dd^Vda, Rr, Rr, Dd^Vda, Dd^Vda, Dd^Vda, Dd^Vda, Dd^Vda, Dd^Vda, Dd^Vda, Rd, Dd, Dd, Dd, Rr, Rr, Rr, Rr, Rr, Rr, Rr, Rr, Rr, Dd^Vda, Dd^Vda, Dd^Vda, Dd^Vdr, Dd^Vda, Dd^Vdr, Dd^Vda, Dd^Vda, Dd^Vda, Rd, Dd, Rd, Dd, Rd, Dd^Vda, Dd^Vda, Dd^Vda, Rd, Dd, Dd^Vda, Dd, Dd, Dd, Dd, Dd, Dd, Dd, Dd, Dd, Dd, Dd, Dd, Dd, Dd, Dd, Dd, Dd, Dd
